startwar=startwar
stopwar=stopwar
online_num=online_num
level=level
setvip=setvip
give=give
mob=mob
make=make
ldrop=ldrop
kick=kick
king=king
denychr=denychr
allowchr=allowchr
addgm=addgm
remgm=remgm
chatoff=chatoff
chaton=chaton
info=info
move=move
se=se
gmov=gmov
hidetalkon=hidetalkon
hidetalkoff=hidetalkoff
nodamageon=nodamageon
nodamageoff=nodamageoff
gmyinshenon=gmyinshenon
gmyinshenoff=gmyinshenoff
call=call
follow=follow
getnotice=getnotice
addnotice=addnotice
remnotice=remnotice
dart=dart
dart2=dart2
zhaohuan=zhaohuan
succeed=succeed
roboton=roboton
robotoff=robotoff
limitchr=limitchr
unlimitchr=unlimitchr
setparam=setparam
getparam=getparam
chongzhi=chongzhi
callhuwei=callhuwei
denyip=denyip
addvcoin=addvcoin